
#############
#           #
#  P        #
#           #
#           #
#           #
#           #
#           #
#           #
#############
